20 12
BBBBBBBBBBBBBBBBBBBB
BBBBBBBBBBBBBBBBBBBB
BBPBA5ABAAAB5AAAAABB
BBABAAAGA3ABBBBIBBBB
BBAAAAABAAABAAAAAABB
BBBBABBBBBBBABBAAABB
BBAAAFAAA2BBHBBAAABB
BBAAAFAAAABAABBBJBBB
BBA0AFA1AABAA5BAAABB
BBAAAFAAAAAAABBAADBB
BBBBBBBBBBBBBBBBBBBB
BBBBBBBBBBBBBBBBBBBB
