30 18
BBBBBBBBBBBBBBBBBBBBBBBBBBBBBB
BBBBBBBBBBBBBBBBBBBBBBBBBBBBBB
BBDAAAAAAABAAAAAFFAABAAAAAAABB
BBBBBBBBJBBAAAAAFFAABA0AAAAABB
BBAAAAAAA5BAAAAAFFAAB(AAAAAABB
BBABAAAAAABAAAAAFFAABAAAAAAABB
BBABBBBABBBAABBBBBBBBBBBBBBBBB
BBABAAAABAAAAAAAAAAAAAAEAAA3BB
BBABAAAABAAAAAAAAA5AAAAEAAAABB
BBABAAAABAAAAAAAAAAAAABBBBBBBB
BBABAAAABAAA4AAAAAAAAABAAAAABB
BBABBBBBBAAAAAAAAAAAAABAAAA5BB
BBAAAAAAGAAAAAAAAAAAAABABBBBBB
BBBBBBBBBBBBBBAABBBBBBBIBAAABB
BBAAAAABAAAAAAAAAAAAAAAABABABB
BBAAAA2BAAAAAAAAAAAAAAAAAABPBB
BBBBBBBBBBBBBBBBBBBBBBBBBBBBBB
BBBBBBBBBBBBBBBBBBBBBBBBBBBBBB
teleporter 23 10 24 4
teleporter 2 14 18 2
dumb 7 10
straightLine 11 11 HORIZONTAL
straightLine 17 9 HORIZONTAL
straightLine 14 3 VERTICAL
wallFollow 21 4 Upwards
