16 13
BBBBBBBBBBBBBBBB
BBBBBBBBBBBBBBBB
BBAAAAABA5BAAPBB
BBBAABABABBABBBB
BBBBABABAAAAAABB
BBBBABABBBABB0BB
BBDBABAABBAABBBB
BBABABBABBBAAABB
BBABAABAAAB5BABB
BBJBAABBBBBBBABB
BBAAA5BAAAGAAABB
BBBBBBBBBBBBBBBB
BBBBBBBBBBBBBBBB
teleporter 7 11 2 2
smart 9 9
